1111111111111111111111111111
1010CE0110010000000000000001
100P00C11C010000000000000001
1001101110010000000000000001
1C00000010010000000000000001
100000C010010000000000000001
1000000000000000000000000001
1000000000000000000000000001
1000000000000000000000000001
1000000000000000000000000001
1000000000000000000000000001
1000000000000000000000000001
1111111111111111111111111111
