1111111
1P00CE1
1000001
1111111